蘜	aaf
䒰	aag
剗	aaj
盞	aal
蘳	aam
苉	aaq
苆	aav
匶	aaw
藂	abc
䔺	abd
䓧	abk
䓝	abl
蔯	abs
蕯	abt
蔭	abw
蔘	acc
蓪	ace
㦯	acg
䓿	acl
䔍	aco
荾	acw
芆	acy
藞	add
菴	adj
荿	adn
荙	adp
蒝	adr
䓫	ads
䓓	adt
蕼	adv
弎	ady
萉	aec
蕦	aed
蓃	aeh
虋	aem
蕣	aep
萖	aeq
蒵	aex
䩯	afb
䩒	afg
鞐	afh
䩲	afo
䩮	afv
鞃	afx
邼	agb
荎	agc
䔷	agg
莍	agi
䓊	agk
薑	agl
蕐	agw
匤	agy
萛	aha
蔖	ahe
蕋	ahh
䓬	ahj
蘆	ahl
蔝	aho
莧	ahq
萀	ahw
㸦	ahy
菭	aic
蔆	aif
蔋	aih
䕕	aij
䕪	ail
莐	aip
蓡	aiv
莈	aiw
蓽	aja
䕎	ajg
勱	ajm
䒶	ajn
逪	ajp
斮	ajr
菒	ajs
䧿	ajw
菎	ajx
䓃	akc
莂	ake
菋	akf
荶	akw
蘻	alb
藣	alc
莮	ale
葨	alg
蘲	all
蕒	alm
蔪	alr
蔨	alu
蒕	alw
蔂	alx
藅	aly
蕽	ama
蓇	ame
荝	amj
蘡	amm
䒻	amn
䒽	amr
䒟	amy
荱	ane
䒒	ang
螶	anj
迣	anp
㰥	anq
䢡	ans
苾	ant
苨	anx
薠	aod
蕿	aoe
薦	aog
蔊	aoj
䑞	aoo
蒾	aop
菧	aoq
䕇	aor
䕰	aot
䕠	aow
薼	aox
䕲	aoy
藆	apa
茡	apb
荌	apv
䔃	apy
芶	aqc
䔳	aqd
㔰	aqh
䓒	aql
藑	aqm
帶	aqp
鴄	aqq
蘤	are
䕫	arh
蘀	arl
菗	arm
菦	arp
䓆	arr
蔱	ars
蒑	arv
藥	arx
薂	ary
藲	asa
䕩	asd
䔠	asi
萰	asl
茦	asm
萙	asp
菻	ass
䖇	ast
葽	asv
蒁	asy
䕝	ate
蕱	ati
㦴	atk
䒦	atp
蓹	att
䓈	atw
蓘	auc
藙	aue
菤	aug
蕄	aun
苝	aux
䕞	auy
蕁	ava
䕅	ave
茟	avg
菉	avi
菑	avl
䔥	avo
菷	avp
䓸	avv
茷	awa
輂	awl
苮	awm
䳍	awq
拲	awr
苰	axc
䔛	axd
藧	axe
䒡	axh
䔋	axi
蔃	axk
蘊	axl
蒳	axm
䒛	axn
蒶	axw
䔻	ayb
䕛	ayd
蘐	aye
䕊	ayl
䧖	baa
陿	bad
隁	baj
聝	bak
䧆	baw
聉	bbm
郰	bcb
埾	bcf
孡	bck
焣	bco
阭	bcq
棸	bcs
陖	bcw
阨	bdb
耾	bdc
隇	bdg
阫	bdh
陭	bds
陦	bdt
聗	bdw
隉	bea
䧟	bee
䏂	beh
聣	beq
䧌	bev
隫	bfa
耺	bfc
隢	bff
聐	bfk
聴	bfl
隯	bfn
陼	bft
㿹	bfu
陚	bga
聙	bge
孲	bgf
䧠	bgj
㭆	bgs
陘	bgv
隬	bgw
䧅	bgx
芔	bhb
陫	bhd
䧋	bhq
䖎	bhw
陗	bie
㞼	bim
隲	bit
㿸	bjl
䧎	bke
聖	bkg
䢺	bmb
䪼	bmd
㔘	bme
䖓	bmh
孾	bmm
欪	bmq
䧙	bmw
䧩	bnb
阠	bnf
隦	bnk
䦼	bnw
䧪	bod
㷦	boo
隣	boq
䧨	bou
䧡	bov
聢	bpg
䏃	bpj
皹	bpl
聹	bpn
䏁	bpu
聜	bpw
䎽	bqa
陒	bqd
陥	bqh
聎	bqi
䧁	bqk
﨩	bqm
䧰	bqo
㚉	bqq
聦	bqr
㝂	brr
陻	bsf
陳	bsj
䧒	bsw
陞	bta
艸	btb
䧗	btj
䧄	btk
聰	btl
隩	btm
阣	btn
䎿	bto
孼	btt
雟	btw
孫	btx
聠	bua
阧	buf
䧧	bug
隡	but
隒	buv
孻	bvh
䎼	bvi
隟	bvj
䧂	bvk
㿳	bvl
聡	bwc
隂	bwd
聄	bwe
聁	bwv
䧍	bww
墬	bxe
䧐	byb
䧇	bye
埅	byf
隮	byj
䧚	bym
䲯	byq
職	byu
阬	byw
㹑	caf
㹏	cak
鴘	caq
犕	cat
斚	ccp
㸻	cct
犡	cda
㹛	cdh
奙	cdj
貵	cdm
牻	cdn
㹉	cdr
㦷	cea
㼧	ceg
㪌	ceh
䳌	ceq
㹘	cfd
㸵	cfk
犢	cfl
㹀	cfp
骦	cgf
牼	cgv
犑	chd
覌	chq
犋	chw
犦	cja
㹇	cjq
㣍	cke
瓵	ckg
刣	ckj
㰧	ckq
辝	cku
巼	ckx
犤	clc
㸶	cld
圅	clu
㹄	clw
㹎	clx
駴	coa
䯀	cob
䮁	coc
騞	cod
騪	coe
馶	cof
駍	cog
騑	coh
駻	coj
䣖	cok
駰	col
駚	com
驏	con
驜	coo
䮟	cop
駠	coq
騩	cor
驃	cos
馲	cot
駢	cou
駸	cov
駖	cow
犥	cox
騙	coy
牸	cpb
犗	cpd
㹆	cpl
㹊	cpw
㸰	cpx
牴	cqa
觕	cqe
鳮	cqo
㸸	crg
犔	cro
牱	csk
㸱	ctb
㸲	cth
牬	ctn
犐	ctu
㸯	cuf
犈	cug
犝	cuj
犃	cuk
㹌	cut
犣	cvl
牷	cwg
㹋	cwh
㸮	cwv
犉	cyb
㹍	cyu
牨	cyw
礷	daa
毻	dae
厪	dak
礣	dal
䃡	daq
礡	das
㿴	dbb
硁	dca
硧	dce
䀾	dch
唘	dck
翃	dcn
礟	dco
犮	dcy
䦈	dda
砈	ddb
䂻	dde
磭	ddf
奭	ddj
厖	ddn
䃎	ddq
碕	dds
礰	ddt
厐	ddx
鬕	dea
䯲	dec
髪	ded
髾	dei
鬘	dej
䰎	dek
㤫	den
鬆	des
磎	dex
鬤	dey
礌	dfl
硳	dfo
礵	dfs
碐	dfw
厔	dgc
碃	dge
䃁	dgf
㻎	dgg
瓳	dgn
烕	dgo
䢕	dgp
㭐	dgs
镾	dgw
㪺	dhh
㫘	dhj
盃	dhl
碵	dhm
㶨	dho
嫑	dhs
䬩	dhw
䂣	dhx
硄	dig
奫	dij
厰	dim
礑	dip
皕	djd
魘	dje
䂺	djs
䃏	djt
㪶	dju
礘	djx
磾	dkk
磒	dkm
厛	dkr
䧺	dkw
㖛	dkx
䂩	dld
礧	dll
䃛	dlp
硱	dls
碅	dlt
磥	dlx
磞	dme
碢	dmn
䫰	dmo
䃬	dmr
碋	dms
磮	dmw
砃	dmy
㝾	dnd
㞂	dne
碿	dni
尵	dnk
尳	dnm
尰	dnt
礦	doa
砿	doc
䂯	dof
磱	doo
礳	dos
磄	dov
䃙	dox
硡	dpd
碂	dpf
䃔	dpk
硿	dpw
尅	dqf
䂧	dqi
剋	dqj
㚚	dqk
砲	dqn
鳫	dqo
奓	dqq
奅	dqt
碀	dqv
㼋	drc
碷	drf
䃇	drm
磈	drq
磤	drv
礫	drx
礉	dry
䃌	dsf
歴	dss
硹	dsw
矺	dta
硚	dtd
䂫	dtg
䂰	dtj
礇	dtm
磻	dto
㥻	dts
磿	dtt
䃑	dtu
磫	dtw
礲	due
㚔	duf
眘	duh
磳	dul
䂭	dur
磸	dus
磏	duv
砕	dvf
䃳	dvl
碯	dvt
砓	dwc
碁	dwd
㫪	dwh
棊	dws
砏	dwv
䃨	dxk
礙	dxt
㕈	dye
䃴	dyf
䂖	dyk
䃶	dyl
碻	dym
硛	dyo
迏	dyp
䃚	dyt
硠	dyv
臟	eaa
毧	ead
臔	eah
膒	eak
貓	eal
朠	eam
朑	ean
䐭	eaq
䝙	ear
㥯	eav
膵	eay
朏	ebm
䳕	ebq
嗠	ebt
腏	ecc
毶	ecd
蜰	ecj
亂	ecm
朘	ecw
㲧	ecy
膸	eda
䐛	edb
脹	ede
肬	edn
脄	edo
䐒	edq
䝠	edr
䐀	eds
䐻	edu
膄	eeh
䏮	eei
䐆	ees
脮	eev
膎	eex
膹	efa
臑	efd
㲕	efe
胿	eff
䏡	efi
腜	efs
膤	efv
毀	efw
䏏	egf
毬	egi
膞	egj
礜	egn
䢐	egp
鴡	egq
䏞	egs
胓	egu
脛	egv
臄	ehg
臚	ehl
覓	ehq
䝞	ehw
頿	ehx
䝣	eia
䏴	eie
䐝	eim
脳	eir
䏚	eit
膌	eiw
蠫	ejj
腢	ejm
㲩	ejn
腂	ejs
䐊	ejx
䐕	ekb
䂟	ekd
毠	eke
乫	ekn
鴐	ekq
㧝	ekr
䪪	eku
妿	ekv
嗧	ekw
膕	ela
䐾	elf
臅	elq
㬷	els
䐃	elt
膃	elw
䐯	elx
腨	emd
爯	emf
帠	emh
䑍	emm
腡	emn
腒	end
腛	eng
腵	enh
䑀	enk
䐖	eno
膠	enw
胒	enx
臎	eny
膅	eov
臕	eox
臗	epa
腪	epl
愛	epn
脃	eqc
䐄	eqe
㪒	eqh
朓	eqi
毥	eqj
鶂	eqq
䏛	equ
㬹	eqv
朡	erb
脪	erd
脈	ere
腯	erf
學	err
䑈	erx
腖	esj
胢	esk
胣	etb
䏦	etd
䐿	etm
膰	eto
貈	etu
腇	etv
䐫	etw
脢	etx
朧	eue
䑌	eus
䐮	eut
膁	euv
膉	euw
䏲	eux
䐚	evb
爭	evh
䐂	evi
䐉	evl
鵎	evq
㼏	evr
腦	evt
䐰	ewh
脫	ewk
䝿	ewm
斞	ewu
朌	ewv
䐪	ewy
腞	exe
䏖	exh
乿	exi
膙	exk
膷	ext
䐞	exu
䏶	exx
朜	eyb
㲙	eyc
䑉	eye
䑋	eyk
䐧	eym
朖	eyv
臷	fag
韯	fah
烖	fao
靀	fap
墆	faq
㘷	far
䨸	fbe
䨡	fbi
逇	fbp
䨯	fbs
霳	fbt
壣	fbx
弆	fca
㙍	fcc
頍	fcd
䨶	fch
刦	fcj
坮	fck
鳷	fcq
攳	fcv
埈	fcw
鼁	fcx
堶	fda
坺	fdc
㙽	fdd
壥	fdl
垯	fdp
埼	fds
垹	fdt
㙩	fdu
坥	feg
㙾	fer
埰	fes
霡	fey
壩	ffa
邽	ffb
壖	ffd
劸	ffe
䨪	ffj
郌	ffk
壊	ffl
霊	ffo
㙪	ffp
䨌	ffq
墻	ffw
鼃	ffx
坉	fgb
䨝	fge
壃	fgl
㽍	fgn
霋	fgv
坘	fgx
䞵	fhc
䟂	fhj
赸	fhm
趤	fhp
趚	fhs
䞼	fhx
䨰	fia
靋	fid
䨟	fif
霑	fih
埫	fim
礼	fin
壋	fip
䨵	fis
䨙	fit
霗	fiw
霐	fix
霔	fiy
汬	fji
堣	fjm
堁	fjs
刱	fjv
㙷	fjx
㣋	fjy
郆	fkb
㓤	fkj
翓	fkn
迼	fkp
鴶	fkq
㙅	fks
㖝	fkx
霬	fla
堌	fld
㙕	fle
㙗	flg
䨓	flk
夁	fll
皾	flm
㥁	fln
䢮	flp
畞	flq
塿	flv
堺	flw
霻	fma
堓	fmd
塴	fme
㘱	fmf
坰	fmk
䨤	fmp
埛	fmw
魗	fna
逺	fne
堩	fng
迃	fnp
䞑	foa
垿	foc
頳	fod
䞓	fog
赪	foh
㙻	foj
䞒	fom
赮	fon
赯	foo
赩	foq
塶	fox
㙆	fpd
塓	fpj
埦	fpq
㨌	fpr
坾	fps
垞	fpt
垵	fpv
䨩	fpy
兘	fqc
埳	fqe
坖	fqf
㒬	fqg
雿	fqi
刓	fqj
塢	fqo
靎	fqq
䨚	fqr
黿	fqx
朮	fqy
堫	frb
塊	frq
㙃	frw
耫	fsg
䎬	fsl
䨛	fsr
䎢	fst
㙘	fsv
耭	fsx
䨋	fta
垎	ftk
墦	fto
耇	ftq
㹈	ftt
垀	ftu
㙡	ftw
壌	fua
達	fup
壛	fuq
墫	fus
墡	fuu
䨧	fuw
赱	fuy
垏	fvg
壗	fvh
堖	fvt
㘺	fwa
塕	fwc
垘	fwd
埨	fwg
䨹	fwh
圿	fwj
堢	fwk
㙸	fwo
堸	fwt
雰	fwv
墢	fwx
䨎	fxc
㙣	fxd
塡	fxh
坲	fxj
㘭	fxn
㙄	fxx
堉	fyc
壞	fyl
㙵	fym
塆	fyo
㙟	fyv
壪	fyx
琖	gaa
㦱	gaf
䍾	gan
烎	gao
䢎	gap
㻸	gaq
璓	gat
瑘	gbb
㻓	gbc
瓍	gbd
㐪	ybw
㺹	gca
戩	gcc
㻆	gce
珆	gck
璚	gcn
瑪	gco
玧	gcq
㻐	gcw
㻟	gda
郉	gdf
珬	gdg
䵡	gdl
迗	gdp
鴌	gdq
瓑	gdt
䨼	gea
䝕	geb
䝌	gec
豲	ged
豯	gee
靚	geh
蟸	gej
䀃	gel
豭	gen
䝈	ger
豧	ges
䝓	gev
豛	gew
豴	gey
邘	gfb
瓀	gfd
珪	gff
琎	gfj
琽	gft
㼀	gfu
珷	gga
玗	ggf
珸	ggk
鄼	ggm
瑨	ggo
璈	ggq
琹	ggs
玶	ggu
㺳	ghc
㒫	ghf
䢥	ghh
琸	ghj
瓐	ghl
璿	ghp
玼	ghx
璖	gia
琑	gie
琺	gif
珖	gig
瑺	gip
珰	giv
㻫	gja
䪲	gjd
琩	gjj
㻴	gjl
㻦	gjm
䢋	gjp
㻛	gjq
瑆	gjt
璟	gjy
郚	gkb
琄	gke
亜	gkj
㐚	gkn
䢩	gkt
珚	gld
環	glg
瓃	gll
㻿	glq
㻒	glt
㻲	glv
㐁	glw
㼈	glx
㓰	gmb
叀	gmc
勣	gme
㔝	gmh
曺	gmj
㺾	gmk
恵	gmn
瑋	gnk
珌	gnt
璆	gnw
璻	gny
㼅	goa
璘	goq
瑄	gpg
㻘	gpj
琯	gpn
瑸	gpr
㻠	gpw
殘	gqa
麺	gqd
㱺	gqh
㱬	gql
㱪	gqn
瑦	gqo
㱱	gqr
殐	gqs
瑔	gri
瓆	grr
琕	grt
瓅	grx
璬	gry
膥	gsd
瑓	gsl
㻷	gsm
琜	gsw
璷	gsy
㻑	gtb
琒	gtd
瑖	gth
琍	gtj
珦	gtm
琁	gtn
璠	gto
瓈	gtq
珴	gtr
㻶	gtv
瑽	gtw
珻	gtx
瑳	gua
瓏	gue
㼁	gug
琣	guk
璔	gul
琷	gun
珓	gur
亊	guv
珶	gux
䣆	gva
坙	gvf
珒	gvg
琭	gvi
璅	gvj
玿	gvk
㼃	gvl
㻏	gvo
玱	gwb
玜	gwc
㻅	gwf
玠	gwj
壐	gwm
㻜	gww
瑑	gxe
瑻	gxm
㼄	gxx
㻻	gyb
珳	gye
玣	gyh
璾	gyj
瓖	gyk
瓌	gyl
㻞	gyn
瓋	gyu
琗	gyw
㻭	gyx
䁥	haa
䁳	had
頥	hah
瞙	haj
䁧	hak
䁐	ham
歫	han
矇	hap
䁮	haq
䀙	hav
矆	haw
齰	hba
齱	hbb
齝	hbc
齮	hbd
齟	hbe
䶧	hbf
䶥	hbh
齪	hbk
䁅	hbl
䶤	hbm
齷	hbn
齳	hbp
䶟	hbq
齗	hbr
齼	hbs
齚	hbt
齴	hbu
齠	hbv
齡	hbw
齔	hbx
䶩	hby
瞲	hcn
䀵	hct
䁊	hcy
矋	hda
郹	hdb
䁭	hdd
䁆	hdj
頉	hdm
䴗	hdq
㮂	hws
睶	hdw
䋰	hwx
䂃	hel
睜	hev
睵	hfa
眎	hfi
瞦	hfk
盶	hfq
䁄	hfu
䀘	hga
眰	hgc
䰘	hgg
䁣	hgj
戲	hgk
眪	hgm
䀎	hgn
眜	hgs
眱	hgx
䁦	hhe
䀡	hhk
鼑	hhn
煛	hho
瞾	hhp
睍	hhq
睄	hie
敊	hih
㦸	hja
㪕	hjh
䁜	hji
戱	hjn
逴	hjp
児	hjq
睲	hjt
㲃	hjx
䁒	hkb
梷	hkc
頕	hkd
睊	hke
敁	hkh
㓠	hkj
瞣	hkk
迠	hkp
眖	hkq
膚	hle
䁵	hlg
㔽	hlk
㪭	hll
䁲	hlm
鹺	hlo
睏	hls
瞜	hlv
㮚	hlw
㕟	hma
眏	hmd
睭	hmf
眮	hmg
卨	hmn
遉	hmp
䁹	hnk
㢟	hnp
郻	hnv
矅	hnw
眤	hnx
矌	hoa
齢	hob
覷	hoh
睒	hoo
瞇	hop
瞨	hou
䁖	hov
虡	how
肻	hpe
睆	hpf
睴	hpl
矃	hpn
眝	hps
敹	hpt
睧	hqa
䙸	hqf
䲣	hqg
覞	hqh
眴	hqj
眗	hqk
矎	hqm
䱷	hqo
覐	hqr
覹	hqt
䁓	hrb
眅	hrc
眽	hre
瞃	hrf
矈	hrp
䁛	hrq
䀿	hrr
睥	hrt
䁻	hrx
䁶	hry
瞫	hsj
㱒	hsk
虨	hss
䁏	hsv
睞	hsw
䀨	htd
歱	htg
㱗	hth
䀩	htk
矀	htm
䀥	htn
睋	htr
虖	htu
瞛	htw
䀲	htx
䁟	hua
眹	hud
矓	hue
䀞	huf
睠	hug
䁬	hul
矙	hun
䁠	huv
䁡	huw
睷	hvg
睩	hvi
眧	hvk
䁽	hvl
㱕	hvp
虥	hwa
瞈	hwc
甝	hwf
䖜	hwh
䖑	hwj
䡞	hwl
睺	hwn
䖚	hwq
睉	hww
眑	hxe
眥	hxh
㫮	hxj
呰	hxk
矊	hxr
䁨	hyb
瞮	hyc
㓺	hyj
瞓	hyk
䁴	hyl
睙	hyn
䁎	hyp
瞝	hyr
䁤	hyu
䀶	hyv
睟	hyw
㳦	iaa
潵	iae
㴖	iaf
淽	iah
渵	ial
瀳	iao
㵴	iau
灄	ibb
碆	ibd
滍	ibh
㳱	ibj
䀀	ibl
泏	ibm
㴷	ibp
錃	ibq
㨇	ibr
漋	ibt
㶌	ibx
涰	icc
㳔	icf
汿	icn
㶠	ico
沇	icq
涘	ict
㵮	ida
汯	idc
㳓	idk
渜	idm
㙙	idn
洃	ido
㳠	idp
渏	ids
湼	iea
泇	iek
灂	iel
㶀	ien
淣	ieq
㶅	ier
㴨	ieu
浽	iev
㳛	iew
沶	ifi
㵢	ifl
湳	ifm
浾	ifo
灀	ifs
涬	ifu
澪	ifw
洷	igc
汙	igf
浗	igi
汅	ign
溍	igo
涇	igv
溼	igx
渄	ihd
瀘	ihl
濬	ihp
泚	ihx
⺌	ihy
㶂	iia
㴺	iid
㵜	iif
洸	iig
涾	iij
㶙	iio
漟	iip
㵉	iis
㵈	iiv
㴢	iiw
㵊	ijb
㴘	ijh
滉	iji
淐	ijj
湡	ijm
㵃	ijp
巣	ijs
湒	ikb
浥	ikc
洖	ikg
況	ikq
㳏	ikr
㳭	iks
㕾	ikx
漍	ila
㶔	ill
㵋	ilm
潿	iln
濁	ilq
涃	ils
溿	ilu
漊	ilv
䣔	imb
淍	imf
㴥	imi
瀴	imm
渦	imn
漴	imp
溄	imt
潂	imu
涺	ind
浘	ine
㴮	ini
湋	ink
瀷	inl
瀈	inp
㶜	inu
泦	inv
㶋	ioe
灋	iog
瀍	ioj
㴹	iop
潾	ioq
灖	ios
㶐	iow
浤	ipd
漃	iph
濅	ipv
涽	iqa
淊	iqe
瀂	iqo
濥	iqp
洶	iqr
汮	iqu
浄	iqv
盜	iqw
汳	irc
垽	irf
湶	iri
淿	irm
滊	iro
㝸	irq
㳺	irt
溵	irv
漑	irx
㶚	isa
㴿	isd
涁	ise
湅	isl
洓	ism
㳐	isn
潥	iso
灪	ist
㜑	isv
暼	itj
㵺	itr
潃	itt
泘	itu
瀄	itv
漎	itw
溠	iua
㳕	iud
㳆	iuf
潧	iul
溬	iun
湴	iuo
㶄	iuq
灁	iur
濶	iut
㵛	iuu
淁	iuv
潣	iuy
㴌	ivd
濜	ivh
㓥	ivj
㴫	ivt
浌	iwa
洑	iwd
滫	iwh
㳜	iws
㳝	iwt
渳	ixb
漲	ixd
泑	ixe
淥	ixi
漒	ixk
沘	ixx
㶆	iyf
涼	iyi
滖	iyk
滈	iym
暱	jaa
昻	jab
昮	jae
螮	jaq
蠨	jav
朂	jbe
㫞	jbh
蜬	jbi
蟶	jbk
曓	jbm
昪	jca
蝃	jcc
㬃	jck
螞	jco
晙	jcw
䘈	jda
蚅	jdb
蛂	jdc
蛨	jdj
蝒	jdl
蝡	jdm
䗁	jds
昽	jdx
㦔	jed
蛠	jee
焽	jeo
晲	jeq
㿢	jer
螇	jex
䘂	jfa
㬨	jfo
㫲	jfp
蚖	jfq
䗋	jfs
蟽	jfu
㬡	jfw
蚈	jga
旽	jgb
蛷	jgi
䗵	jgl
㫫	jgo
㦹	jgq
昩	jgs
蛵	jgv
鼂	jgx
暃	jhd
蝆	jhg
晫	jhj
曥	jhl
迧	jhp
㒻	jhq
朄	jhs
䗂	jhw
蟕	jhx
蟝	jia
㫾	jim
䖢	jit
蝋	jiw
蝐	jjh
蟃	jjl
㬂	jjm
㫣	jjn
焸	jjo
暥	jjp
㫀	jjr
暒	jjt
䗑	jju
㬤	jjx
蜎	jke
蚛	jkh
暺	jkk
㫛	jkq
蟈	jla
蝟	jle
蜖	jlj
蠝	jll
蠋	jlq
螹	jlr
蜠	jlt
螻	jlv
㬅	jly
螖	jme
蠳	jmm
蝸	jmn
蛧	jmr
蝄	jmu
㬆	jna
蜛	jnd
毾	jne
曯	jni
暐	jnk
旸	jnr
蚇	jny
蟅	joa
昿	joc
顕	jod
蟧	joo
暽	joq
䗫	jos
螰	jox
曢	jpd
晥	jpf
䗆	jpn
䗏	jpo
䖳	jpt
螲	jpw
㬕	jpy
蚔	jqa
蜭	jqe
曻	jqg
㫬	jqj
蜔	jql
㬇	jqm
蚫	jqn
螐	jqo
蛥	jqq
蟂	jqs
㬠	jqv
䗜	jqy
蝬	jrb
昄	jrc
暤	jrd
䖰	jre
暭	jri
㫹	jrn
暣	jro
螝	jrq
晣	jrr
曒	jry
褁	jse
蝀	jsj
暕	jsl
晽	jss
㪙	jst
蜙	jsw
昇	jta
蜏	jtb
蛒	jtk
蟌	jtl
䗴	jtt
䗻	jtv
暰	jtw
暛	jua
曨	jue
㬝	jul
䗒	juo
䝉	jup
蠀	juq
螏	jut
螊	juv
螠	juw
䗹	jux
蟳	jva
曃	jvi
蠟	jvl
㫶	jvp
䳛	jvq
蟘	jwa
昣	jwe
䖫	jwf
䗛	jwh
㫟	jwk
䗄	jwr
昐	jwv
䘋	jww
昲	jxj
䗰	jxm
曏	jxt
蜟	jyc
㬯	jye
蠩	jyf
蟺	jyl
暠	jym
蠔	jyp
晬	jyw
㖑	kaa
嘆	kak
㗣	kaq
囒	kau
囁	kbb
唨	kbe
㖤	kbi
㗦	kbq
䣈	kck
㘐	kco
咗	kda
吰	kdc
喕	kdl
哤	kdn
嚦	kdt
哹	keb
㖬	kec
嗋	kee
㘀	keo
啋	kes
哸	kev
嗘	kex
哋	kfb
呩	kfi
嚋	kfn
㖼	kfs
啈	kfu
咞	kga
咥	kgc
呯	kgu
啑	kgv
跴	khs
唦	kii
嘡	kip
㘍	kiw
嗶	kja
呾	kjg
嗢	kjl
嗮	kjs
雖	kjw
噐	kka
郘	kkb
哵	kke
戰	kkj
㖞	kkm
嘂	kkn
斝	kkp
呪	kkq
䣞	kku
㖐	kkv
喌	kky
嘓	kla
嚃	kli
嘪	klm
嗹	klp
噣	klq
㖥	klt
嚺	klu
嘍	klv
囉	klx
㗄	kly
哃	kmg
喎	kmn
吶	kmt
㗀	kmx
㗃	kna
啒	knb
啹	knd
囑	kni
噀	knn
㗩	knr
嘐	knw
喥	koa
㖢	koh
噒	koq
嗐	kpd
唍	kpf
喗	kpl
啘	kpq
咹	kpv
咜	kpx
㖧	kqa
㗋	kqd
嘝	kqe
咷	kqi
咰	kqj
呴	kqk
嚕	kqo
嘄	kqs
呁	kqu
喼	kqv
嚠	kqy
㕳	krb
唕	krf
啲	krq
咑	krs
喞	krx
噭	kry
喖	ksd
㘄	ksl
唽	ksr
喓	ksv
嘜	ksw
唀	ktb
咶	ktd
啣	ktg
嘚	ktj
囖	ktl
嚟	ktq
㗛	ktt
㘉	ktv
㗰	ktw
咲	kud
嚨	kue
呌	kuf
㖣	kuk
嗴	kun
嚪	kuq
噂	kus
喭	kut
㘂	kux
噚	kva
㗲	kvf
㖀	kvg
㖨	kvi
嗈	kvk
嘨	kvo
唚	kvp
䬭	kvw
㖉	kwh
吤	kwj
嗰	kwl
㰨	kwq
喺	kwt
咈	kxj
㖰	kxm
嚩	kxs
㘈	kxt
㖎	kxw
㗒	kye
噈	kyi
嗃	kym
囄	kyr
㗜	kyx
軭	lag
轞	lah
羃	laj
䡸	lal
轥	lau
異	law
輙	lbc
䡕	lbi
輽	lcd
㔥	lce
圗	lcf
囼	lck
圎	lcm
㙒	lcn
罵	lco
㽙	lcq
畯	lcw
䍔	ldc
盢	ldl
輭	ldm
罽	ldo
欭	ldq
轑	ldu
罦	leb
輗	leq
轒	lfa
轜	lfd
䍣	lfl
䡹	lfp
轌	lfv
䡜	lfw
疅	lgl
軏	lgq
軯	lgu
輕	lgv
䡖	lgw
軙	lhc
䡾	lhg
轤	lhl
䡠	lhm
輎	lie
塁	lif
輄	lig
䍝	lij
疂	lip
䳴	liq
罼	lja
囬	ljf
畼	ljg
䡬	ljl
輵	ljq
輠	ljs
㘣	lke
䡲	lkk
廻	lkp
軦	lkq
䍛	lld
罳	lln
轋	llp
轀	llw
圐	lly
圌	lmd
畘	lmf
鷶	lmq
㽯	lmw
轏	lnb
罻	lnf
䡂	lnh
圍	lnk
㘠	lnt
辘	lox
畳	lpe
輐	lpf
䡣	lpl
輨	lpn
䡥	lpw
䡐	lpx
軝	lqa
輡	lqe
㝶	lqf
軥	lqk
䡘	lql
䍖	lqn
鴨	lqo
䡔	lqq
輷	lqy
䍟	lrb
磛	lrd
蹔	lrk
㟻	lrm
慙	lrn
㨻	lrr
㽡	lrt
㜞	lrv
䭕	lrw
轢	lrx
圑	lsf
輏	lsg
罧	lss
軠	ltf
䡻	lth
輹	ltj
䡯	ltl
轓	lto
䡮	ltw
䍙	ltx
㽨	lua
䡵	lue
䡭	lun
輶	lus
罤	lux
䣚	lvb
氀	lve
輺	lvg
罺	lvj
遱	lvp
鷜	lvq
輑	lvt
㪹	lvu
繋	lwc
圙	lwd
囶	lwf
朙	lwm
畟	lwt
輍	lww
䡏	lxc
軪	lxe
羄	lxh
羂	lxk
邏	lxw
畩	lye
罜	lyg
輬	lyi
䡢	lyn
䍠	lyr
䍚	lyv
㽘	lyw
羉	lyx
贜	maa
㟙	maj
購	mam
岠	man
嵽	maq
峣	mat
贓	mau
崡	mbi
㟹	mbq
峅	mca
嵾	mcc
㟥	mcd
巁	mda
㿮	mdb
贆	mdd
峸	mdn
㠣	mdt
嶚	mdu
賰	mdw
髒	mea
㟊	meb
㟬	meh
䯑	mei
䯣	mek
䯞	mem
髆	mes
骿	meu
㟎	mev
嵠	mex
賳	mfa
贖	mfl
㟑	mfp
㞿	mfr
崚	mfw
峌	mgc
㠝	mgg
峘	mgj
嶆	mgm
峛	mgq
崨	mgv
峓	mgx
帴	mha
幓	mhc
幍	mhe
帩	mhi
帵	mhp
㡊	mhq
帄	mhs
㠴	mhv
㠲	mhx
幟	mhy
巌	mid
埊	mif
崉	mij
䞆	mim
贘	mip
䍏	mjg
䞎	mjj
嵎	mjm
崐	mjx
嶯	mkb
㞻	mkg
㞲	mkh
㠆	mkk
迥	mkp
㟕	mku
嶉	mkw
嶧	mlf
嵔	mlg
㠥	mll
㟺	mlv
嶩	mma
㟨	mmd
崗	mmu
崌	mnd
嶎	mnf
㟃	mng
㠔	mnk
㠄	mnr
㞾	mnx
㠧	mos
嶪	mou
㟰	mpj
賱	mpl
䝹	mpq
貯	mps
㟉	mpt
峖	mpv
岮	mpx
崏	mqa
嶰	mqe
翙	mqn
嶌	mqo
嵚	mqq
岉	mqr
㰞	mqw
嵧	mqy
㟅	mrb
㟛	mrf
崥	mrt
嶊	mrw
嶘	msa
嵿	msd
崬	msj
㠨	msr
崊	mss
䝯	mtb
崜	mtf
貹	mtg
岝	mth
峲	mtj
賉	mtl
㠗	mtm
嶓	mto
㠟	mtq
㠅	mtt
嵷	mtw
胐	mub
脧	muc
巃	mue
㟡	mug
剛	mum
嶈	muq
峧	mur
嶟	mus
嵃	mut
膧	muu
賹	muw
峍	mvg
贐	mvh
㟤	mvi
岧	mvk
崰	mvl
峮	mvt
岃	mvy
嵡	mwc
䝩	mwe
峜	mwh
岕	mwj
冏	mwk
嵐	mwt
岎	mwv
㟆	mwx
岰	mxe
巓	mxh
岪	mxj
嵹	mxk
㟜	mxq
嵶	mxu
雘	mya
㠡	myc
䝬	myg
㠇	myi
峕	myj
㠤	myk
㠙	myp
鴅	myq
崺	myt
崀	myv
崒	myw
䝮	myx
㞡	naa
䪸	nad
愅	naf
㥱	nah
懄	nak
愥	nam
懞	nap
㦅	naq
㦩	nbe
聼	nbf
㥛	nbk
惙	ncc
愑	nce
忬	ncn
恈	nct
慅	ncy
翇	ndc
㤢	nde
屒	ndf
㤑	ndk
愐	ndl
鶋	ndq
㥳	ndr
㥓	nds
㤽	ndt
憭	ndu
㥭	ndw
懚	nea
恊	nee
屗	nef
愋	neg
㥰	neh
㞙	nei
㥅	nep
㥒	nes
㥚	new
慀	nex
屆	nfb
蝨	nfj
懤	nfn
㷉	nfo
懎	nfw
㞗	ngi
㤄	ngm
㤡	ngq
悽	ngv
夨	ngy
臦	nha
郿	nhb
叏	nhc
戄	nhh
㿿	nhl
㠯	nhn
憈	nho
疎	nhs
䎓	nij
劚	nil
憆	nip
悩	nir
懪	nja
愰	nji
㦙	njm
䎈	njn
㤤	njr
惈	njs
惃	njx
悁	nke
郼	nkg
屌	nkm
悞	nkn
怳	nkq
怾	nkw
㥜	nle
懌	nlf
恛	nlk
愢	nln
慩	nlp
屢	nlv
慍	nlw
㦬	nlx
憹	nma
愲	nme
屭	nmm
㤯	nmw
㦑	nnb
鵋	nnq
慴	nnr
怭	nnt
懭	noa
憦	noo
憐	noq
懡	nos
㦠	nou
㦇	nox
屪	npd
悰	npf
愃	npg
慏	npj
悺	npn
㤖	nps
㤞	npt
悾	npw
惛	nqa
㥮	nqb
恑	nqd
恌	nqi
怐	nqk
愌	nqm
怉	nqn
䲩	nqo
㞔	nqq
㤘	nqv
忺	nqw
懰	nqy
㦻	nra
忷	nrb
㤆	nrc
恡	nrd
愾	nro
懫	nrr
飁	nrw
㦡	nrx
憿	nry
慓	nsf
憛	nsj
㞖	nsm
憟	nso
忔	ntn
㞏	ntp
鴓	ntq
憡	nts
㤏	ntu
㦢	ntv
㞞	ntw
憪	nue
㦖	nun
遅	nup
恔	nur
㞟	nus
愱	nut
怓	nvc
㦎	nvf
㥆	nvi
舝	nvp
憏	nwf
刔	nwj
悅	nwk
翭	nwn
鴂	nwq
恘	nws
㤛	nwt
懺	nww
㥝	nxb
怮	nxe
愼	nxh
迡	nxp
䲿	nxq
懝	nxt
愵	nxu
惤	nxy
惇	nyb
㥔	nyc
翯	nym
㦪	nyo
悢	nyv
慉	nyx
烒	oaa
糤	oae
煂	oaf
熞	oah
庿	oal
䢠	oap
廗	oaq
糚	oau
㸎	obb
廰	obf
炪	obm
㢌	obs
廕	obw
糝	occ
㷁	oce
炲	ock
㶼	oct
焌	ocw
糔	ocy
爄	oda
炦	odc
類	odd
煃	odf
炐	odh
糆	odl
庬	odn
烣	odo
㷧	odr
㢊	ods
爏	odt
煁	odw
粀	ody
燬	oea
烰	oeb
熁	oee
㷐	oef
燰	oep
熎	oet
燌	ofa
烓	off
廟	ofj
廚	ofk
煵	ofm
爀	ofo
㶿	ofp
燵	ofu
燯	ofw
㢅	oga
庢	ogc
㶺	ogd
㡰	ogf
㸇	ogg
炡	ogh
廌	ogn
粖	ogs
烴	ogv
䨾	ohd
㢒	ohe
㸍	ohg
㢚	ohl
粯	ohq
庛	ohx
焇	oie
䊑	oim
糛	oip
黺	oiw
熶	ojb
焨	oje
㡺	ojg
熀	oji
焻	ojj
庽	ojm
㡼	ojn
㷎	ojq
粿	ojs
焺	ojt
燳	ojv
焜	ojx
焆	oke
㶽	okm
炾	okq
廙	ola
煟	ole
㐣	oln
燭	olq
焑	ols
廔	olv
熅	olw
燶	oma
䊘	ome
廁	omj
粣	omm
煱	omn
㷨	omt
焵	omu
烱	omw
烿	omy
䊊	one
籸	onf
煒	onk
㢞	onl
焗	onn
熤	onu
熫	ooa
顃	ood
㲜	ooe
烾	oof
敥	ooh
㷀	oon
罃	oop
燐	ooq
䊳	oos
爊	oox
爎	opd
㶶	ope
熐	opj
熍	opk
煇	opl
廀	opo
焥	opq
䊉	ops
烢	opt
炨	opx
焔	oqh
庣	oqi
㶷	oqj
䊅	oqk
㢝	oqo
㢁	oqq
㷓	oqr
㡻	oqt
糉	orb
炍	orc
庪	orf
熂	oro
廆	orq
䊛	ors
廏	orx
燩	ory
㷑	osf
燂	osj
煉	osl
䊂	osm
爩	ost
庲	osw
灹	ota
炧	otb
庅	otc
爋	otg
烅	otl
熪	otq
㢉	ott
㸅	otv
㢔	otw
烸	otx
庰	oua
㡿	oub
燑	ouj
熷	oul
爓	ouq
烄	our
燇	ous
㷽	ouu
熌	ouw
燘	ouy
燖	ova
炤	ovk
爉	ovl
籾	ovy
焧	owc
爚	owg
炌	owj
㢋	owq
煈	owt
庼	oxd
㶭	oxe
粌	oxh
纇	oxi
炥	oxj
彂	oxt
糑	oxu
焴	oyc
庡	oye
䊰	oyf
炞	oyh
㸄	oyj
爙	oyk
㸀	oym
㷜	oyo
㷚	oyp
㷰	oyr
冣	pbc
㝮	pbm
㝫	pbt
寕	pdl
宬	pdn
実	pdw
冩	peq
寀	pes
寪	pet
冡	pfe
寘	pfh
宑	pfj
㝨	pfk
䢘	pfp
宯	pft
㝙	pgg
寳	pgq
寚	pgt
寁	pgv
寊	phm
宐	phn
寖	piv
寔	pjg
䥌	pjj
宺	pkg
宲	pks
宮	pkt
顐	pld
運	plp
鶤	plq
寠	plv
寷	pmd
㝕	pnc
㝭	pnj
㲰	pnl
賔	pnm
悹	pnn
叜	poc
㝩	pov
䪴	pqd
瓭	pqg
沊	pqi
寏	pqm
㱽	pqw
㝌	pqy
寙	prc
冟	prx
䫅	psd
㿾	psl
冧	pss
㝯	ptd
㝚	pth
⺳	ptn
㔤	pto
䘼	pup
鞌	pva
頞	pvd
䀂	pvl
鴳	pvq
宭	pvt
㝧	pvw
窡	pwc
䆩	pwh
䆮	pwi
䆭	pwl
䆑	pws
宖	pxc
㼠	pxg
䙾	pxh
實	pxm
迱	pxp
寲	pxt
祴	pya
䄌	pyc
䄕	pyi
祻	pyl
禟	pyo
禈	pyp
禋	pys
禴	pyw
禒	pyx
鑶	qaa
鏾	qae
氒	qaf
鑮	qai
鍈	qam
鐕	qaq
銰	qar
䥬	qas
钄	qau
鑷	qbb
䤴	qbi
鐊	qbj
鈯	qbm
䥙	qbu
妴	qbv
錣	qcc
銿	qce
鈶	qck
䥁	qcl
鎷	qco
鈗	qcq
鉾	qct
鋑	qcw
䤻	qda
銆	qdj
鋴	qdq
錡	qds
觨	qea
鋢	qeb
觭	qed
錋	qee
觶	qek
䚪	qel
觿	qem
䚬	qeo
鑀	qep
觗	qeq
䚗	qew
䚥	qex
䚝	qey
鐵	qfa
鎑	qfc
銈	qff
銢	qfi
鎱	qfk
鑄	qfn
䤲	qfo
鋍	qfp
鈨	qfq
銇	qfs
﨨	qfu
錴	qfw
鲿	qgi
銕	qgx
鑡	qhb
鈙	qhc
錹	qhe
钁	qhh
鐪	qhl
鍞	qhm
鐤	qhn
䥧	qhp
鋧	qhq
鎼	qhr
鏬	qht
錿	qhw
頫	qid
覙	qih
錔	qij
鴵	qiq
鎃	qir
鏎	qja
鎤	qji
錩	qjj
鍝	qjm
迿	qjp
鍟	qjt
鍓	qkb
㗮	qko
斪	qkr
敂	qkt
鉙	qkw
酁	qkx
䥯	qlc
鐸	qlf
䤽	qli
䤧	qlk
鑸	qll
鏩	qlr
鏤	qlv
鎅	qlw
錪	qma
鏰	qme
䤡	qmf
銏	qmm
鎽	qmt
钃	qni
馉	qnm
炰	qno
䱆	qob
鯒	qoc
䱮	qod
鰩	qoe
魼	qof
鯖	qog
䱙	qoh
鵿	qoj
䱒	qok
鯝	qol
鱡	qom
鰕	qon
䳹	qop
䲬	qoq
魬	qor
鯂	qos
魠	qot
鯩	qow
鑳	qpa
鋐	qpd
䥱	qpe
䥂	qpf
鍕	qpl
錧	qpn
䤹	qpo
鋺	qpq
䤩	qpt
鎺	qpy
錉	qqa
卶	qqb
䤥	qqd
錎	qqe
㩼	qqf
銁	qqj
㚋	qqm
翗	qqn
鑥	qqo
迻	qqp
䤭	qrd
鍎	qrf
鎎	qro
鑕	qrr
錍	qrt
㬟	qru
鋲	qrw
鑠	qrx
䥮	qsa
鄡	qsb
鍊	qsl
錰	qso
鑻	qsr
䥑	qsw
猟	qti
鎈	qua
鎙	qub
鑨	que
鏳	qul
鐥	quu
鎌	quv
鐞	qva
録	qvi
鏁	qvj
鎻	qvm
䤦	qwa
鎓	qwc
鉁	qwe
鉜	qwf
鎀	qwh
銝	qws
銋	qwt
鈖	qwv
䤸	qxe
鐑	qxf
鈏	qxh
銯	qxi
鏆	qxm
鈚	qxx
鉒	qyg
鑇	qyj
鍽	qyn
䢣	qyp
掿	rad
擆	raf
捓	rah
擓	rai
掝	rak
搆	ram
摕	raq
撱	rbd
掹	rbl
兇	rbq
挅	rbs
㚇	rbw
掻	rcj
抁	rcq
㨊	rda
㩡	rdd
拵	rdh
揼	rdi
拻	rdo
摤	rdr
挷	rdt
揑	rea
捊	reb
拁	rek
皭	rel
掜	req
㩭	rer
採	res
挼	rev
㨙	rex
㩥	rfa
擩	rfd
捇	rfo
撻	rfu
挵	rga
挃	rgc
皝	rgi
摶	rgj
㩖	rgl
㧊	rgm
㧚	rgn
挒	rgq
擟	rgw
㨞	rgx
㪂	rhc
掓	rhi
擄	rhl
揁	rhm
㩬	rho
挸	rhq
摢	rht
㨗	rhv
䴘	rhw
皉	rhx
㧟	ria
皐	rif
挄	rig
挱	rii
㧺	rij
灥	rir
楽	ris
㩧	rja
㩎	rje
㨪	rji
捰	rjs
掍	rjx
撔	rjy
拀	rkq
抧	rkw
摑	rla
擺	rlc
攌	rll
揌	rln
摙	rlp
擉	rlq
摲	rlr
摟	rlv
搵	rlw
擃	rma
搰	rme
抩	rmf
㩄	rml
㧏	rmr
掆	rmu
捤	rne
扟	rnf
㩣	rnp
紥	rnx
拡	roc
撛	roq
攠	ros
擈	rou
捬	row
攗	rox
攐	rpa
㨠	rpj
捾	rpn
捥	rpq
挓	rpt
拕	rpx
㧪	rqd
㧦	rqj
揔	rqr
抣	rqu
㨑	rrb
皞	rrd
爼	rre
埑	rrf
捳	rrm
烲	rro
摋	rrs
娎	rrv
䭁	rrw
䋢	rrx
抲	rsk
揀	rsl
拺	rsm
㩒	rss
殺	rsw
摥	rtj
挌	rtk
摠	rtl
擙	rtm
㧰	rtn
抸	rtp
㩍	rts
擳	rtv
摐	rtw
㩯	rtx
㨰	ruc
攏	rue
撯	ruh
掽	ruo
摪	ruq
搤	ruw
揹	rux
撏	rva
揤	rvb
㩇	rvf
摷	rvj
擸	rvl
掃	rvp
抮	rwe
扴	rwj
挩	rwk
挆	rws
拰	rwt
墍	rxa
㩪	rxd
㩩	rxi
摾	rxk
撧	rxq
擬	rxt
㨯	ryb
挔	rye
抃	ryh
㩝	ryp
㰾	ryq
摛	ryr
楛	sad
橵	sae
㭱	sal
㮜	sau
櫹	sav
檴	saw
㯜	say
㮀	sbi
極	sbk
柮	sbm
樄	sbs
㯁	sbu
㭓	sca
棳	scc
椮	scd
枱	sck
㮭	scl
榪	sco
㭇	scq
桙	sct
楕	sda
枙	sdb
柭	sdc
㰁	sdd
桭	sdf
栢	sdj
槗	sdk
㮌	sdl
䙴	sdn
榞	sdr
檓	sea
㭩	sef
㮴	seh
橓	sep
棿	seq
㰒	ser
棌	ses
㮳	seu
桵	sev
楰	sew
榽	sex
欛	sfa
檽	sfd
橶	sfj
桲	sfp
杬	sfq
楳	sfs
樰	sfv
梂	sgi
醳	sgl
桱	sgv
棑	shd
樝	she
欔	shh
枮	shk
㯭	shl
梘	shq
㯉	sht
椃	shw
橴	shx
㭼	sij
㭻	sim
㮿	sja
樶	sjb
㭴	sjc
柛	sjh
榥	sji
槾	sjl
㭿	sjq
䰤	sjr
梋	ske
㐓	skn
㪼	skr
辢	sku
枴	skv
喸	skx
槶	sla
㭷	sle
欙	sll
楒	sln
梿	slp
㼑	slr
梱	sls
棞	slt
樓	slv
楐	slw
樏	slx
㰄	sma
椯	smd
榾	sme
枏	smf
㭎	smr
敇	smt
榐	sna
梶	sne
㭄	snf
蚻	snj
椲	snk
榓	snt
榌	snu
樛	snw
紮	snx
樜	soa
㯶	sob
㔄	soj
櫦	son
橯	soo
橉	soq
㯅	sor
榳	sot
櫠	sow
樚	sox
椬	spe
榠	spj
楎	spl
㭦	spt
榟	spu
榊	spy
枊	sqb
栒	sqj
㭵	sql
槝	sqm
枹	sqn
櫓	sqo
栘	sqq
楤	sqr
枃	squ
棦	sqv
杴	sqw
梍	sra
椶	srb
㭛	sre
楯	srf
槹	sri
晳	srj
惁	srn
榝	srs
椑	srt
橷	sru
梹	srw
梎	srx
辳	ssd
栜	ssm
䢞	ssp
㯄	ssr
柂	stb
㭚	ste
椼	sti
楿	stj
桖	stl
覂	stp
㰀	stq
櫛	stv
樅	stw
㮶	sub
櫳	sue
梉	suf
栤	sui
橧	sul
椪	suo
櫩	suq
槉	sut
橏	suu
椄	suv
榏	suw
楖	svb
㯸	svh
樔	svj
柖	svk
椔	svl
梫	svp
䳩	svq
榋	svv
栰	swa
覄	swd
樇	swh
厀	swi
柗	swk
㯷	swo
栣	swt
㮆	swu
椕	swv
㯑	sxd
槇	sxh
栺	sxj
㯞	sxk
樌	sxm
㰘	sxo
檰	sxr
榒	sxu
櫅	syj
㰔	syo
橠	syq
㯎	sys
㯠	syx
箋	taa
䉈	tae
徣	taj
䅦	tal
笹	tan
徔	tap
箃	tbc
頺	tbd
䈄	tbi
笜	tbm
䉌	tbu
䈨	tbv
䉁	tbw
穇	tcc
䅟	tcd
筩	tce
篤	tco
稄	tcw
䢴	tdb
叐	tdc
箶	tde
矲	tdl
舕	tdo
徛	tds
䂏	tdv
穩	tea
䈈	tec
稲	teh
穱	tel
稱	tem
䉣	teq
䈻	tes
籐	teu
䅑	tev
徯	tex
啎	tfg
㣮	tfm
籌	tfn
稑	tfw
鼄	tfx
秷	tgc
怣	tgn
䅉	tgo
䉔	tgq
甧	tgt
徑	tgv
勧	tgw
䇘	tgx
郋	thb
䈛	thm
簴	tho
䫵	thp
筧	thq
辠	thu
箎	thw
篊	tia
笵	tib
箈	tic
篞	tij
簹	tip
筜	tiv
馢	tja
穝	tjb
䭰	tjd
馟	tje
䅛	tjj
䅼	tjl
䈳	tjn
馪	tjp
鋫	tjq
馦	tju
㴝	tjw
箟	tjx
箿	tkb
䇼	tkc
頟	tkd
䅌	tke
洜	tki
㓢	tkj
䎊	tkn
鵅	tkq
㪾	tkr
敋	tkt
範	tlb
䘒	tlc
稩	tle
衆	tli
䉪	tll
簤	tlm
䘔	tlp
稇	tls
簵	tlt
簍	tlv
䉂	tlx
䘑	tly
穠	tma
䅢	tme
笧	tmm
䈑	tmn
奧	tmt
笍	tmw
徾	tmy
笢	tna
䦾	tnc
䅕	tnd
徦	tnh
刉	tnj
徫	tnk
帥	tnm
鴭	tnq
箳	tnu
穋	tnw
秜	tnx
笖	tny
䉀	toa
䎹	tob
㣸	toe
甃	tog
稥	toj
簩	too
鍫	toq
揫	tor
醔	tos
䅊	tot
䉬	tow
簺	tpa
秾	tpe
徖	tpf
䈿	tpj
䇡	tps
秺	tpt
簶	tpy
籛	tqa
䈥	tqe
笣	tqn
穭	tqo
笉	tqu
䇜	tqw
䆋	tqx
䉧	tqy
稯	trb
籜	trl
篺	trr
䉟	trw
篐	tsa
䉦	tsd
䈾	tsi
簠	tsl
䉘	tsp
籕	tsq
䈷	tst
徠	tsw
秅	tta
䅎	ttb
䅨	ttj
笿	ttk
䉛	ttm
䉒	tto
䉫	ttq
筿	tts
䈲	ttu
箻	ttv
篵	ttw
龝	ttx
舥	tuc
䑩	tud
艔	tuo
䉃	tuq
䈉	tuv
穊	tva
節	tvb
笯	tvc
箓	tvi
䉋	tvn
簘	tvo
筗	twk
鵚	twq
秹	twt
聳	tww
䈙	txf
䉲	txg
彿	txj
䈫	txm
箹	txq
䌓	txw
㒰	tya
稕	tyb
勶	tyc
簱	tyd
籝	tye
笇	tyh
㒲	tyj
㣶	tyl
籇	typ
鳰	tyq
徬	tyu
笐	tyw
稸	tyx
郱	uab
㔙	uae
齹	uah
䡨	ual
牃	uan
㷢	uao
艵	uaq
㭍	uas
㿄	uat
剙	uav
㽾	ubm
痾	ubs
癊	ubw
䍳	ucc
瘆	ucd
䇈	ucf
闖	uco
竢	uct
㾍	udm
羱	udr
㾨	uds
癧	udt
痭	uee
奨	uef
弉	ufa
癗	ufl
㓓	ufm
䦝	ufo
䢏	ufp
銺	ufq
㓑	ufu
娤	ufv
開	uga
痓	ugc
瘧	uha
㾥	uhi
竨	uhj
㿖	uhl
門	uhn
䦩	uht
痟	uie
䦢	uif
䦞	uig
闛	uip
㵷	uiu
頀	uja
痩	ujh
韻	ujk
遧	ujp
韹	ujr
㾧	ujs
䪭	uju
䪩	ujw
閺	ujy
㾓	uke
敨	ukt
疻	ukw
兾	ula
凙	ulf
瘝	uli
㿙	ull
瘻	ulv
癑	uma
㾶	ume
痌	umg
瘑	umn
闝	umt
㓏	umw
羗	unc
瘺	unf
閟	unt
竮	unu
痆	unx
䇊	uoc
羻	uon
竤	upd
竩	upe
羦	upf
凕	upj
瘒	upl
痯	upn
㽸	upq
竚	ups
羫	upw
䍫	upx
痀	uqk
癬	uqo
痑	uqq
㾠	uqt
㿁	urd
効	ure
㾮	urg
闎	uri
䢒	urp
瘣	urq
兿	urv
䦨	usj
㾊	usm
凚	uss
闄	usv
竔	uta
痵	utb
瘇	utg
䦗	utl
㓔	utm
㾭	uto
疺	utp
産	utt
瘲	utw
痗	utx
癇	uue
䇆	uuf
竲	uul
㿕	uuq
㾾	uuv
㾒	uvk
㓎	uvp
㿏	uvt
辧	uvu
䘱	uwk
㾋	uws
瘋	uwt
竕	uwv
癈	uwx
瘬	uxd
㘳	uxf
丠	uxg
辮	uxi
疿	uxj
䉾	uxo
㼱	uxp
䇏	uyb
㓍	uyc
㾵	uyf
癠	uyj
譱	uyy
嫟	vaa
媶	vab
婼	vad
鄩	vak
媌	val
姖	van
孏	vau
㝷	vav
嬳	vaw
㚤	vay
㚺	vbb
娵	vbc
嫷	vbd
䳭	vbq
㚫	vby
砮	vcd
媽	vco
鴑	vcq
拏	vcr
娭	vct
㛖	vcw
媠	vda
妭	vdc
姷	vde
㚰	vdh
㛪	vdj
媔	vdl
媆	vdm
娍	vdn
娔	vdq
嫄	vdr
婍	vds
媋	vdw
㜒	vea
娐	veb
嫍	vee
㚳	vek
㛵	vem
婗	veq
婇	ves
媱	vet
娞	vev
㜎	vex
彟	vfa
嬬	vfd
畵	vfl
婻	vfm
嬦	vfn
㛘	vfp
㛬	vfw
姪	vgc
姸	vgd
婭	vgf
㛏	vgi
嫥	vgj
婳	vgl
姉	vgm
㜜	vgq
妺	vgs
㛁	vgu
嬭	vgw
婔	vhd
㜘	vhe
⺻	vhg
㜹	vhh
婌	vhi
媜	vhm
娊	vhq
嫭	vht
媫	vhv
婋	vhw
娋	vie
姯	vig
㪖	vih
盝	vil
媣	viv
媢	vjh
媀	vjm
㛫	vjq
婫	vjx
妕	vkh
刟	vkj
嬋	vkk
㚾	vkq
挐	vkr
桇	vks
䘫	vky
䣎	vlb
媦	vle
嬽	vlh
㓯	vlj
㜥	vlm
媤	vln
㜕	vlp
鶅	vlq
㜢	vlv
媼	vlw
姍	vma
婩	vmd
姌	vmf
媧	vmn
孈	vmw
㜊	vna
婮	vnd
㚨	vnf
㜨	vni
媁	vnk
嫪	vnw
嫬	voa
㛇	vof
粛	voj
嬫	voo
㜆	vop
嫾	voq
嫞	vov
彛	vow
彞	vox
婃	vpf
媈	vpl
婠	vpn
㛮	vpo
㜚	vpw
媰	vqb
姽	vqd
姰	vqj
㛟	vqm
㚿	vqn
䲥	vqo
姼	vqq
㚹	vqt
㛀	vqv
㛂	vrc
㛓	vrd
婂	vrm
媿	vrq
㜱	vrr
婢	vrt
娦	vrw
㜰	vrx
嬓	vry
娻	vsj
媡	vsl
㛦	vss
婹	vsv
婡	vsw
奼	vta
㛢	vtb
娳	vtj
㜩	vtm
嬏	vto
姂	vtp
㚵	vtu
婑	vtv
㜡	vtw
䶯	vtx
嫺	vue
婘	vug
婄	vuk
㛨	vun
嫸	vuu
㜋	vuw
㜦	vva
嬧	vvh
娽	vvi
㜉	vvk
婦	vvp
㛴	vvt
妐	vwc
婨	vwg
妎	vwj
媬	vwk
娰	vwn
㚯	vwr
㛊	vws
姙	vwt
妢	vwv
㛗	vww
姈	vwy
嬵	vxr
嫋	vxu
㛩	vyc
孃	vyk
妔	vyw
㜅	vyx
㑘	waa
傇	wab
儰	wae
㑈	wai
傼	wak
㑤	wal
偀	wam
佢	wan
㑁	wbm
鸧	wbq
傪	wcc
佁	wck
傌	wco
兊	wcq
枀	wcs
伌	wdb
伖	wdc
侟	wdh
偭	wdl
偄	wdm
偧	wdq
傆	wdr
㒚	wea
俷	wec
倗	wee
偁	wem
僢	wep
倸	wes
俀	wev
傒	wex
儥	wfl
㑲	wfm
侼	wfp
発	wfq
㑍	wfs
倖	wfu
倰	wfw
㑝	wga
伅	wgb
佂	wgh
俓	wgv
儞	wgw
仾	wgx
俶	whi
佔	whk
儢	whl
㒠	whq
偼	whv
佌	whx
侊	wig
偗	wit
儤	wja
㑠	wjc
㖋	wjk
僈	wjl
傝	wjn
儑	wjx
偮	wkb
俋	wkc
傊	wkm
俁	wkn
兌	wkq
㑨	wkt
伿	wkw
個	wld
侽	wle
㒁	wlf
佪	wlk
偲	wln
僆	wlp
㒔	wlq
㑼	wlt
僂	wlv
傫	wlx
儂	wma
偳	wmd
傰	wme
伣	wmq
偋	wnu
僇	wnw
㑞	woa
儍	wob
僗	woo
僯	woq
侂	wot
㒒	wou
儦	wox
僿	wpa
倧	wpf
傢	wpg
㑮	wpl
倇	wpq
佇	wps
侘	wpt
侒	wpv
尩	wqg
侚	wqj
偩	wqm
佨	wqn
鳯	wqo
俇	wqt
伨	wqu
㑇	wqv
㐸	wqw
倄	wrd
飔	wrl
㸗	wrm
㑟	wrw
儌	wry
僊	wsd
價	wsm
恷	wsn
偠	wsv
倯	wsw
㑧	wtb
佫	wtk
㑗	wtm
僠	wto
㒐	wtq
傱	wtw
傞	wua
儱	wue
佽	wuq
僔	wus
㑵	wut
倿	wuv
偝	wux
餞	wva
餌	wvb
餟	wvc
餿	wve
饖	wvh
饄	wvi
饅	wvj
䭂	wvk
饝	wvo
飹	wvq
餺	wvs
餅	wvu
䬰	wvv
䬦	wvw
餯	wvx
韱	wwa
倊	wwc
睂	wwh
伱	wwi
佡	wwm
㐽	wwr
偑	wwt
㒩	wxe
伄	wxh
㒙	wxr
儗	wxt
發	wxw
顀	wyd
雋	wyh
儃	wyl
傐	wym
㒅	wyq
傗	wyx
綫	xaa
縙	xab
繖	xae
䌑	xah
縸	xaj
緎	xak
緢	xal
緓	xam
㣅	xaq
䌨	xaw
䌰	xbb
䋼	xbc
䋪	xbs
㢽	xbx
経	xcf
㢱	xci
䥒	xcj
絠	xde
䋔	xdh
絾	xdn
䋾	xdq
縓	xdr
縥	xdw
䌥	xea
孧	xeb
䌐	xeh
盠	xel
䋩	xeq
綵	xes
縘	xex
纎	xfa
繻	xfd
繧	xff
頴	xfi
續	xfl
䋻	xfm
綍	xfp
䌮	xfs
緈	xfu
絰	xgc
綪	xge
纉	xgg
絚	xgh
絿	xgi
㣂	xgk
弳	xgv
㣆	xgw
䊺	xgx
㢭	xhc
盄	xhl
緽	xhm
顚	xhn
繉	xhq
紪	xhx
㣄	xia
絖	xig
弾	xij
䋝	xiv
彃	xja
繓	xjb
㔗	xje
縨	xji
䌈	xjn
綶	xjs
䭫	xju
䭬	xjv
縜	xkm
絪	xld
緭	xle
繹	xlf
絗	xlk
纝	xll
縺	xlp
㢴	xlr
綑	xls
縷	xlv
縕	xlw
繷	xma
紻	xmd
繃	xme
絅	xmk
緺	xmn
遦	xmp
㢷	xmq
䋧	xnd
䌵	xni
緯	xnk
䌌	xnr
䋇	xny
彍	xoa
絋	xoc
熲	xod
緂	xoo
繗	xoq
䌕	xos
䌜	xou
彜	xow
綋	xpd
彙	xpj
緷	xpl
綩	xpq
紵	xps
縡	xpu
紽	xpx
縐	xqb
繎	xqd
繲	xqe
絇	xqk
䳇	xqo
緫	xqr
綯	xqt
弞	xqw
緵	xrb
絺	xrd
䋸	xrf
線	xri
䌆	xrq
䋂	xrr
綼	xrt
纅	xrx
㯋	xsd
綀	xsk
練	xsl
䌚	xso
䌝	xss
䌁	xsv
䋱	xsw
緮	xtj
總	xtl
繙	xto
䌣	xtp
鄕	xtr
郷	xtv
䋦	xtx
鄉	xty
縒	xua
縌	xub
䌬	xue
紏	xuf
䋨	xuk
䌪	xuq
繜	xus
絕	xvc
縁	xve
繣	xvf
䋖	xvg
繍	xvo
綅	xvp
総	xwc
絥	xwd
紾	xwe
縧	xwh
紒	xwj
緥	xwk
纀	xwo
絍	xwt
㿫	xxb
繈	xxc
紖	xxh
顈	xxi
繦	xxk
粊	xxo
枈	xxs
䘡	xxy
弴	xyb
袰	xye
紸	xyg
弶	xyi
緕	xyj
縗	xyk
繵	xyl
綂	xyq
綷	xyw
讛	yaf
講	yam
䜏	ybd
讔	ybe
亸	ybu
諁	ycc
旀	yci
夣	ycl
褭	yco
誜	ycw
訍	ycy
䜔	yda
詙	ydc
詴	yde
誫	ydf
㕻	ydh
䛳	ydj
謜	ydr
旑	yds
诪	ydt
䜍	ydu
譭	yea
驘	yec
䘚	yef
謏	yeh
䊨	yeo
䛵	yep
誽	yeq
謑	yex
䜟	yfa
詓	yfc
譳	yfd
讀	yfl
誖	yfp
䛃	yfq
䙝	yfu
褻	yfw
訰	ygb
誈	ygc
䛩	ygf
譛	ygg
䜊	ygm
瓬	ygn
迬	ygp
謸	ygq
誙	ygv
殶	ygw
䛾	ygx
謯	yhe
諔	yhi
詀	yhk
譃	yho
䜜	yhp
斍	yhq
謼	yht
諕	yhw
訿	yhx
誻	yij
鶁	yiq
訬	yit
斔	yje
詚	yjg
亰	yji
齎	yjm
䛖	yjn
齌	yjo
䛕	yjr
謃	yjt
䶒	yjv
䜙	yjx
諿	ykb
詋	ykq
㐯	ykt
㖜	ykx
畆	ylc
褱	yli
讄	yll
諰	yln
謰	ylp
畝	ylq
謱	ylv
譨	yma
諯	ymd
諣	ymn
誷	ymu
肈	yna
䋜	ync
朚	ynj
㧂	ynl
扊	yno
鳸	ynq
謵	ynr
㦿	yns
䋀	ynx
亪	yog
䛸	yoh
変	yot
誴	ypf
谉	ypj
䯧	ypm
䛷	ypq
詑	ypx
䛄	yqb
椉	yqg
誂	yqi
㪱	yqm
袌	yqn
鴍	yqo
袲	yqq
詾	yqr
䚿	yqw
訋	yqy
䛀	yrc
誵	yrd
䛻	yrf
䛲	yrm
謉	yrq
䜠	yrr
諀	yrt
諲	ysf
䜖	ysm
諃	yss
䜉	ysw
䛂	yta
旓	yti
誗	ytj
詻	ytk
謥	ytl
旙	yto
䢟	ytp
旐	ytq
旂	ytr
旚	yts
旞	ytu
旍	ytw
譲	yua
䜇	yuc
䚵	yuf
詊	yug
譄	yul
詨	yur
詉	yvc
旔	yvg
剆	yvj
誛	yvp
欴	yvq
㓪	yvv
㫅	ywf
㫆	ywi
亱	ywj
迒	ywp
䲳	ywq
䛙	yws
訜	ywv
詏	yxe
訠	yxh
謴	yxm
牽	yxp
䲻	yxq
孶	yxy
旈	yyc
堃	yyf
䜞	yyj
讓	yyk
謞	yym
譹	yyp
斏	yyv
詃	yyx

